["WWWWWWWWWWWWWWWWWWWWWWWWWWWWWWWWWWWWWWWWWWWWWWWWWWWWWWWWWWWWWWWWWWWWWWWWWWWWWWWWWWWWWWWWWWWWWWWWWWWWWWWWWWWWWWWWWWWWWWWWWWWWWWWWWWWWWWWWWWWWWWWWWWWWWWWWWWWWWWWWWWWWWWWWWWWWWWWWWWWWWWWWWWWWWWWWWWWWWWWWWWWWWWWWWWWWWWWWWWWWWWWWWWWWWWWWWWWWWWWWWWWWWWWWWWWWWWWWWWWWWWWWWWWWWWWWWWWWWWWWWWWWWWWWWWWWWWWWWWWWWWWWWWWWW",
 "------------------------------WWWWWWWWWWWWWWWWWWWWWWWWWWWWWWWWWWWWWWWWWWWWWWW-----------------------------------------n-------n---n-----n------------------------WWWWWWWWWWWWWWWWWWWWWWWWWWWWWWWWWWWWWWWWWWWWWWWWWWWWWWWWWWWWWWWWWWWW-------------------------------------------------------------------------------W",
 "-------------------------------WWWWWWWWWWWWWWWWWWWWWWWW-----------------------------------------------------------------wW----------------------------------------WWWWWWWWWWWWWWWWWWWWWWWWWWWWWWWWWWWWWWWWWWWWWWWWWWWWWWWWWWWWWWWWWW--------------------------------------------------------------------------------W",
 "--------------------------------WWWWWWWWWWWWWWWWWWWWWW-------------------------------------------------------------------n---------------------ww-------------------WWWWWWWWWWWWWWWWWWWWWWWWWWWWWWWWWWWWWWWWWWWWWWWWWWWWWWWWWWWWW-----------------------------------------------------------------------------------W",
 "---------------------------------WWWWWWWWWWWWWWWWWWWW--------------------------------------------------------ws------------------------------------------------------WWWWWWWWWWWWWWWWWWWWWWWWWWWWWWWWWWWWWWWWWWWWWWWWWWWWWWWWWWW------------------------------------------------------------------------------------W",
 "-----------------------------------WWWWWWWWWWWWWWW---------------------------------------------------------------------------------------N---------------ws------------WWWWWWWWWWWWWWWWWWWWWWWWWWWWWWWWWWWWWWWWWWWWWWWWWWWWWWW--------------------------------------------------------------------------------------W",
 "--------------------------------------WWWWWWWWW--------------------------------------------------------------------------w--------------wW--------------------------------WWWWWWWWWWWWWWWWWWWWWWWWWWWWWWWWWWWWWWWWWWWWWWWWW-----------------------------------------------------------------------------------------W",
 "------------------------------------------m-----------------------------------------------------------------------------------------------------------------------------------WWWWWWWWWWWWWWWWWWWWWWWWWWWWWWWWWWWWWWWWWW--------------------------------------------------------------------------------------------W",
 "------------------------------------------m------------------------------------------------------------------------------------w----------------------------------------------------WWWWWWWWWWWWWWWWWWWWWWWWWWWWWWWW------------------------------------------------------------------------------------------------W",
 "------------------------------------------m-----------------------m---m--------------------------------------------wss------------------------------------------------------------------------------m---------------------------------------------------------------------------------------------------------------W",
 "------------------------------------------m----------------------m--m--------------------------------------------------------------------------------ws---------------------------------------------m---------------------------------------------------------------------------------------------------------------W",
 "------------------------------------------m--------------------------------------------------------------------------------N------------------------------------------------------------------------m---------------------------------------------------------------------------------------------------------------W",
 "------------------------------------------m-------------------------------------------------------------------------------wWs-----------------------------------------------------------------------m-------------------------------------------------------------------------------------------------b-------------W",
 "-----------------------------------------------------------------m-m-F-F-----------------------------------ws---------------------------------ws----------------------------------------------------m---------------------------------------------------------------------------------------------------------------W",
 "--------------------------------------------------------------------------------------------------------------------N-------------------------------------------------------------------------------m---------------------------------------------------------------------------------------------------------------W",
 "-----------------------------------------------------------------F-------------------------------------------------wW-----------ws------------------------------------------------------WWWWWWWWWWWWWWWWWWWWWWWWWW--------------------------------------------------------------------------------------------------W",
 "------------------------------f-f--------------------------------F-----------------------------------------------------------------------------------------------------------------WWWWWWWWWWWWWWWWWWWWWWWWWWWWWWWWWWWW---------------------------------------------------------------------------------------------W",
 "-------------------------------f-f-------------------------------f-----------------------------------------------------------------------ws------------------------------------WWWWWWWWWWWWWWWWWWWWWWWWWWWWWWWWWWWWWWWWWWWW-----------------------------------------------------------------------------------------W",
 "-----------------------------------------------------------------F---------------------------------------------w-----------------------------------------------------------WWWWWWWWWWWWWWWWWWWWWWWWWWWWWWWWWWWWWWWWWWWWWWWWWWWW-------------------------------------------------------------------------------------W",
 "-----------------------------------------------------------------f------------------------------------------------------------------------------------------------------WWWWWWWWWWWWWWWWWWWWWWWWWWWWWWWWWWWWWWWWWWWWWWWWWWWWWWWWWW----------------------------------------------------------------------------------W",
 "----------------------------------------------------------WWWWWWWWWWWWWW--------------------------------------------wW------------------------------------------------WWWWWWWWWWWWWWWWWWWWWWWWWWWWWWWWWWWWWWWWWWWWWWWWWWWWWWWWWWWWWW--------------------------------------------------------------------------------W",
 "-------------------------------------------------------WWWWWWWWWWWWWWWWWWW-------------------------------------------n----------------------------------------------WWWWWWWWWWWWWWWWWWWWWWWWWWWWWWWWWWWWWWWWWWWWWWWWWWWWWWWWWWWWWWWWW-------------------------------------------------------------------------------W",
 "-----------------------------------------------------WWWWWWWWWWWWWWWWWWWWWWW--------------------------------------------------------------------------------------WWWWWWWWWWWWWWWWWWWWWWWWWWWWWWWWWWWWWWWWWWWWWWWWWWWWWWWWWWWWWWWWWWWW------------------------------------------------------------------------------W",
 "----------------------------------------------------WWWWWWWWWWWWWWWWWWWWWWWWW----------------------------------ws---------N-----N---N-----N--------------ws------WWWWWWWWWWWWWWWWWWWWWWWWWWWWWWWWWwWWWWWWWWWWWWWWWWWWWWWWWWWWWWWWWWWWWW-----------------------------------------------------------------------------W",
 "WWWWWWWWWWWWWWWWWWWWWWWWWWWWWWWWWWWWWWWWWWWWWWWWWWWWWWWWWWWWWWWWWWWWWWWWWWWWWWWWWWWWWWWWWWWWWWWWWWWWWWWWWWWWWWWWWWWWWWWWWWWWWWWWWWWWWWWWWWWWWWWWWWWWWWWWWWWWWWWWWWWWWWWWWWWWWWWWWWWWWWWWWWWWWWWWWWWWWWWWWWWWWWWWWWWWWWWWWWWWWWWWWWWWWWWWWWWWWWWWWWWWWWWWWWWWWWWWWWWWWWWWWWWWWWWWWWWWWWWWWWWWWWWWWWWWWWWWWWWWWWWWWWWWW"]